2 1 0
+----------------------+-----------------------------------------------+---------------------------------------------------+
|                      |                                               |                                                   |
|                      |                                               |                                                   |
|                      |                                               |                                                   |
|                      |                                               |                                                   |
|                      |                                               |                                                   |
|                      |                                               |                                                   |
|                      |                                               |                                                   |
|                      |                                               |                                                   |
|                      |                                               |                                                   |
|                      |                                               |                                                   |
|                      |                                               |                                                   |
|                      |                                               |                                                   |
|                      |                       |                       |                                                   |
|                      |                       |                       |                                                   |
|                      |                       |                       |                       |                           |
|                      |                       |                       |                       |                           |
|                      |                       |                       |                       |                           |
|                      |                       |                       |                       |                           |
|                      |                       |                       |                       |                           |
|                      |                       |                       |                       |                           |
|                      |                       |                       |                       |                           |
|                      |                       |                       |                       |                           |
|                      |                       |                       |                       |                           |
|                      |                       |                       |                       |                           |
|                      |                       |                       |                       |                           |
|                      |                       |                       |                       |                           |
|                      |                       |                       |                       |                           |
|                      |                       |                       |                       |                           |
|                      |                       |                       |                       |                           |
|                      |                       |                       |                       |                           |
|                      |                       |                       |                       |                           |
|                      |                       |                       |                       |                           |
|                      |                       |                       |                       |                           |
|                      |                       |                       |                       |                           |
|                                              |                                               |                           |
|                                              |                                               |                           |
|                                              |                                               |                           |
|                                              |                                               |                           |
|                                              |                                               |                           |
|                                              |                                               |                           |
|                                              |                                               |                           |
|                                              |                                               |                           |
|                                              |                                               |                           |
|                                              |                                               |                           |
|                                              |                                               |                           |
|                                              |                                               |                           |
+----------------------------------------------+-----------------------------------------------+---------------------------+