15 5 0
+--------------------------------------------------------------------------------------------------------------------------------------------+
|                                                                                                                                            |
|                                                                                                                                            |
|                                                                                                                                            |
|                                                                                                                                            |
|                                                                                                                                            |
|                                                                                                                                            |
|                                                                                                                                            |
|                                                                                                                                            |
|                                                                                                                                            |
|                    +--------------------------------------------------------------------------------------------------+                    |
|                    |                                                                                                  .                    |
|                    |                                                                                                  |                    |
|                    |                                                                                                  |                    |
|                    |                                                                                                  |                    |
|                    |                                                                                                  |                    |
|                    |                                                                                                  |                    |
|                                          +----------------------------------------------------------+                                      |
|                                          |**********************************************************|                                      |
|                                          |**********************************************************|                                      |
|                                          |**********************************************************|                                      |
|                                          |**********************************************************|                                      |
|                                          |**********************************************************|                                      |
|                                          |**********************************************************|                                      |
|                                          |**********************************************************|                                      |
|                                          +----------------------------------------------------------+                                      |
|                    |                                                                                                  |                    |
|                    |                                                                                                  |                    |
|                    |                                                                                                  |                    |
|                    |                                                                                                  |                    |
|                    |                                                                                                  |                    |
|                    |                                                                                                  |                    |
|                    +--------------------------------------------------------------------------------------------------+                    |
|                                                                                                                                            |
|                                                                                                                                            |
|                                                                                                                                            |
|                                                                                                                                            |
|                                                                                                                                            |
|                                                                                                                                            |
|                                                                                                                                            |
|                                                                                                                                            |
+--------------------------------------------------------------------------------------------------------------------------------------------+
